111111111111111111111
200100100010000000001
100101101010101110101
110001101010101010101
111010101111101011101
100000000000101000101
111011111110101011101
100010001000000000101
111010111110111011101
100000101000100010001
101111101011101111101
100010000000101000101
101011111110101110111
101000100010101010001
111011101110111011101
100000101010000000101
111010101011101010101
101010001010001010001
101110111010111111101
100000100000000000103
111111111111111111111
